1111111111111
1111111111111
1111111111111
1111111111111
1111111111111
1000000000001
1111111111111
1111111111111
1111111111111
1111111111111
1111111111111
1000000000001
1001o00000011
1111111111111
1C0000E00P001
1111111111111
